0 0 0 0 0 0 0 0 0 0 0 0 0 0 0 0 0 0 0 0 0 0 0 0 0 0 0 0 0 0 0 0 0 0 0 0 0 0 0 0 0 0 0 0 0 0
0 0 0 0 0 0 0 0 0 0 0 0 0 0 0 0 0 0 0 0 0 0 0 0 0 0 0 0 0 0 0 0 0 0 0 0 0 0 0 0 0 0 0 0 0 0
0 0 10 10 0 0 0 0 0 0 10 10 10 10 10 10 0 0 0 10 10 0 0 10 10 0 0 0 0 0 0 0 0 0 5 7 7 5 0 5 7 5 0 0 0 0
0 0 10 10 0 0 0 0 0 0 10 10 10 10 10 10 0 0 0 10 10 0 0 10 10 0 0 0 0 0 0 0 0 0 5 7 8 8 8 5 8 7 7 5 0 0
0 0 10 10 0 0 0 0 0 0 10 10 0 0 10 10 0 0 0 10 10 0 0 10 10 0 0 0 0 0 0 0 0 0 5 8 7 8 8 8 8 8 8 5 0 0
0 0 10 10 0 0 0 0 0 0 10 10 0 0 10 10 0 0 0 10 10 0 0 10 10 0 0 0 0 0 0 0 0 0 0 5 7 8 8 8 8 8 8 5 0 0
0 0 10 10 0 0 0 0 0 0 10 10 10 10 10 10 0 0 0 10 10 0 0 10 10 0 0 0 0 0 0 0 0 0 0 0 5 7 8 8 8 8 7 5 0 0
0 0 10 10 0 0 0 0 0 0 10 10 10 10 10 10 0 0 0 10 10 0 0 10 10 0 0 0 0 0 0 0 0 0 0 0 5 8 7 8 8 7 5 0 0 0
0 0 10 10 10 10 0 0 0 0 10 10 0 0 10 10 0 0 0 10 10 10 10 10 10 0 0 0 0 0 0 0 0 0 0 0 0 5 5 7 7 5 0 0 0 0
0 0 10 10 10 10 0 0 0 0 10 10 0 0 10 10 0 0 0 10 10 10 10 10 10 0 0 0 0 0 0 0 0 0 0 0 0 0 0 5 5 0 0 0 0 0
0 0 0 0 0 0 0 0 0 0 0 0 0 0 0 0 0 0 0 0 0 0 0 0 0 0 0 0 0 0 0 0 0 0 0 0 0 0 0 0 5 0 0 0 0 0
0 0 0 0 0 0 0 0 0 0 0 0 0 0 0 0 0 0 0 0 0 0 0 0 0 0 0 0 0 0 0 0 0 0 0 0 0 0 0 0 0 0 0 0 0 0
